<map>
000000000000000000000000000000000000000000000000000000000000000001010101010114000000000000040404040404000000000000000000000000000000000000000000000000000000000000000000010101010101010101010101010101010101010101000000000000000000000000000000000000000000000000000000000000000000000000000000000000000000000000000101010101010101
000000000000000000000000000000000000000000000000000000000000000001000000000001000000000000010101010101000000000000000000000000000000000000000101010101010101000000000000010001000100010001000100010001000100010001000000000000000000000000000000000000000000000000000000000000000000000000000000010101010100000000000100000000000001
000000000000000000000000000000000000000000000000000000000000000001000000000001000000000000010000000001000000000000000000000000000000000000000100000000000001000000000000010101010101010101010101010101010101010101000000000000000000000000000000000000000000000000000000000000000000000000000000010001000100000000000100000000000001
000000000000000000000000000000000000000000000000000001010101010101000000000001000000000000010000000001000000000000000000000000000000000000000100000000000001000000000000010001000000000000000000000000000000000000000000000000000000000000000000000000000000000000000000000000000000000001010101010101010100000000000100000000000001
000000000000000000000000000000000000000000000000000001000000000000000000000001000000000000140101010101000000000000000000000000000000000000000101010101010101000000000000010101000600060006000600060006000600060000000000000000000000000000000000000000000000000000000000000008000000000001000100010000000000000000000100000000000001
000000000000000000000000020000000000000000000000000001000000000000000000000001000000000000000000000000000000000000000000000001010101010101010000000000000000000000000000010001000000000000000000000000000000000000000000000001010101010000000101010000000101010000000101010101010101010101010101010000000000000000000101010101010101
000000000000000000000000000000000000000001010101010101000000000000000000000001000000000000000000000000000000000000000000000001000000000000010000000000000000000000000000010101000000000000000000000000000000000000000000000001000100010000000100010000000100010000000100010001000100010001000000000000000000000000000000000000000000
000000000000000000000000000000000000000001000000000000000000000000000000000001000000000000000000000000000000000000000000000001000000000000010000000000000000000000000000000000000000000000000000000000000000000000000000000001010101010000000101010000000101010000000101010101010101010101000000000000000000000000000000000000000000
000000000000000000000000000000000000000001000000000000000000000000000000000001000000000000000009000000000000000000000000000001010101010101010000000000000000000000000000000000000000000000000000000000000000000000010101010100000000000000000000000000000000000000000000000000000000000000000000000000000000000000000000000000000000
010101010101010101010101010101010101010101000000000000000000000000000000000001000000000000120101010101010101010101010101010100000000000000000000000000000000000000000000000000000000000000000000000000000000000000010001000100000000000000000000000000000000000000000000000000000000000000000000000000000000000000001111111111111111
000000000000000000000000000000000000000000000000000000000000000000000000000001000000000000010000000000000000000000000000000100000000000000000000000000000000000000000000000000000000000000000000000000000000000000010101010100000000000000000000000000000000000000000000000000000000000000000000000000000000000000000100000000000001
000000000000000000000000000000000000000000000000000000000000000000000000000001000000000000010000000000000000000000000000000100000000000000000000000000000000000000000000010101010101010110010101010110010101010101000000000000000000000000000000000000000000000000000000000000000000000000000000000000000000000000000100000000000001
010101010101010101010101010101010101010101010101010101010101010101010101010101000000000000010101010101010101010101010101010100000000000000000000000000000000000000000000010001000100010001000100010001000100010001000000000000000000000000000000000000000000000000000000000000000000000000000000000000000000000000000100000000000001
000000000000000000000000000000000000000000000000000000000000000000000000000000000000000000000000000000000000000000000000000000000000000000000000000000000000000000000000010101010101010101010101010101010101010101000000000000000000000000000000000000000000000000000000000000000000000000000000000000000000000000000101010101010101
</map>
<tip>
Save your jump for when you really need it.
</tip>