<map>
00000000000000000000000000000000000000000000000000000000000000000000000000000000000000000000000000000000000000000000000000000000000000000000000014000000000000000014000000000000000000000000000000000000000000
00000000000000000000000000000000000000000000000000000000000000000000000000000000000000000000000001010101010101010101010101010000000000000000000000000000000000000000000000000000000000000000000000000000000000
00000000000000000000000000000000000000000000000000000000000000000000000000000000000000000000000000000000000000000000000000010000000000000000000000000000000000000000001400000000000000000000000000000000000000
00000000000000000000000000000000000000000000000000000000000000000000000000000000000000000000000000000000000000000000000000010000000000000000000012010110000000000000000000000000000000010101010101010101010100
00000000000000000000000000000000000000000000000000000000000000000000000000000000000000000000000000000000000000000000000000010000000000000000000006000006000000000000000000140000000000010000000000000000000100
00000000000000000000000000000000000000000000000000000000000000000000000000000101011400000000000001010101010101010101000000010000000000140000000000000000000000000000000000000000000000010000000000000000000100
00000000000000000000000000000000000000000000000000000000000000000000000000000100000100000000000000000000000000000201000000010000000000000000000000000000000000000000000000000014000000140000000000000000000100
00000000000000000000000000000000000000000000000000000000000000000101010100000100000100000000000000000000000000000001000000010000000000000000000000000000000000000000000000000000000000000000000000000000000100
00000000000000000000000000000000000000000000000000000000000000000100000100000100000100000000000000000000000000000001040404010000000000120101100000000000000000000000000000000000001400000000000011111111110100
00000000000000000000000000000101010100000000000000000101010100000100000100000100000100000000000014010101010101010101010101010000000000060000060000000000000000000000000000000000000000000000000000000000000100
00000000000000000000000000000100000100000000000000000100000100000100000100000100000100000000000000000000000000000000000000000000000000000000000000000000000000000000000000000000000000120000000000000000000100
00000000000000000101010100000100000100000101010100000100000100000100000100000100000100000000000000000000000000000000000000000000000000000000000000000000000000000000000000000000000000010000000000000000000100
00000000000000000100000100000100000100000100000100000100000100000100000100000100000100000000000000000000000000000000000000000000000000000000000000000000000000000000000000000000000000010000000000000000000100
00000000000000001200001200001200001200001200001200001200001200001200001200001200001200000000000012010101010101010101010101010101011000000000000000000000000000000000000000000000000000010101010101010101010100
</map>
<tip>
It's so lonely in here. Well, see you later!
</tip>