<map>
000000000000000000000000000000000000000000000000000000
000000000000000000000000000000000000000000000000000000
000000000000000000000000000000000000000000000000000000
000000000000000000000000000000020000000000000000000000
000000000000000000000000000000000000000000000000000000
000000000000000000000000000000000000000000000000000000
000001010101010101000000000000000000000000000000000000
000000000000000001000000000101010101010101111111111111
000000000000000001000000000100000000000000000000000000
000000000000000001000000000100000000000000000000000000
000000000000000001010101010100000000000000000000000000
000000000000000000000000000000000000000000000000000000
000000000000000000000000000000000000000000000000000000
000000000000000000000000000000000000000000000000000000
</map>
<tip>
Tap anywhere on the screen to jump. You probably already figured that out...
</tip>